8
8
..###...
..#C#...
..#.####
###c.cC#
#C.c@###
####c#..
...#C#..
...###..
