9
9
#####....
#...#....
#.c@#.###
#.cc#.#C#
###.###C#
.##....C#
.#...#..#
.#...####
.#####...
