8
8
.####...
.#.@###.
.#.c..#.
###.#.##
#C#.#..#
#Cc..#.#
#C...c.#
########
