7
8
..#####.
###..@#.
#..cC.##
#..CcC.#
###.$c.#
..#...##
..#####.
