8
8
..####..
..#CC#..
.##.C##.
.#..cC#.
##.c..##
#..#cc.#
#..@...#
########
