7
8
########
#..#...#
#.cCCc.#
#@cC$.##
#.cCCc.#
#..#...#
########
