7
9
######...
#....#...
#..c.##..
#..#CC###
##.c$Cc.#
.#@.....#
.########
