8
7
#######
#CCcCC#
#CC#CC#
#.ccc.#
#..c..#
#.ccc@#
#..#..#
#######
