8
8
.#####..
.#.@.###
##.#c..#
#.$C.C.#
#..cc.##
###.#C#.
..#...#.
..#####.
