9
6
######
#....#
#.c@.#
##$..#
#.$.##
#.$.#.
#.$.#.
#.C.#.
#####.
